.W....WW.......WW....
.W...............W...
WW................W..
WX.................W.
WW..................W
.W..........W..B....W
.W..........WB.BBD..W
.WWWWW...WWWWWWWWWWWW
.....W..BW...........
.....WWWWW...........
