.W.................
.W...WWWWWWWWWWWWW.
W.W.W.............W
W..W..............W
W................BW
W...............BBW
W.WWW....D...WB.WW.
W.W.W....W..WWWWW..
W.W.WBB.WW..W......
WXW.WWWWWW.WW......
WWW.WW...WWW.......